NO ./files/textures/brown.xpm
EA ./files/textures/yns.xpm
WE ./files/textures/33.xpm
R 800 600
SO ./files/textures/44.xpm
S ./files/textures/sprite.xpm

F 50,150,50
C 255,130,80

           1111111  111111111111111
 1 11111111000000011000000000000001
 111110000001111111111111111111111011
  111000000001112211111111111111111111111
111100000000122112100000010000111101
1011020000W000001200000010001000001
10110000012222122100000010000111111
100000021 111112111101111000011111111
11110001    1101100000001000000000001
   10001    1101100101001000111111111
111100021  121011000000010001
10000000211200001000200010001
10000000000000001000000010001
12000000011110011001010010001
1111011111  11011000000010001
1000000001  10000111011100001
1111101111  10000000000000001
    101     11111111111111111
    111  
