NO ./files/textures/purplestone.xpm
EA ./files/textures/wood.xpm
WE ./files/textures/purplestone.xpm
R 800 600
SO ./files/textures/wood.xpm
S ./files/textures/barrel.xpm

F 144,139,139
C 0,128,255

           1111111  111111111111111
 1 11111111000000011000000000000001
10110E00011100000020000010002111101
10110000000000100000000010001200001
10110000211200000000000010002111111
100000021  12000211101111000211111111
11110001    1101100000001000000000021
   10001    1101100101001000111111111
111100021  121011000000010001
12000000211200001000200010001
10000000000000001000000010001
12000000211112011001010010001
1111011111  11011000000010001
1000000001  10002111011120001
1111101111  10000000000000001
    101     11111111111111111
    111                          
