R 1920 1080
NO ./path_to_the_north_texture
SO ./path_to_the_south_texture
WE ./path_to_the_west_texture
EA ./path_to_the_east_texture
S ./path_to_the_sprite_texture
F 220,100,0
C 225,30,0

		111111111111111111111111
		100000000011E000000000001
		1011000001110000002000001
		1001000000000000000000001
111111111011000001110000000000001
10000000001100001110111111111111
11110111111 1101 100000010001
11110111111 1101 101010010001
1100000011010101 100000010001
1000200000000001 100000010001
1000000000000001 11010010001
1100000111010101 111011110011
111S011111101011 111100001
1111111111111111 111111111
