NO ./files/textures/11.xpm
WE ./files/textures/22.xpm

R 80 60

S ./files/textures/chevalier.xpm
SO ./files/textures/test3.XPM


EA ./files/textures/test.xpm

C 211,93,34
F 68,40,25

           1111111  111111111111111
 1 11111111000000011000000000000001
 111110000001111111111111111111111011
  111000000001112211111111111111111111111
111100100000122112100000010000111101
101101 100S000001200000010001000001
10110010012222122100000010000111111
100000021 111112111101111000011111111     111
11110001    1101100000001000000000001     111
   10001    1101100101001000111111111
111100021  121011000000010001
10000000211200001000200010001
10000000000000001000000010001
12000000011110011001010010001
1111011111  11011000000010001
1000000001  10000111011100001
1111101111  10000000000000001
    101     11111111111111111
    111