NO ./files/textures/11.xpm
EA ./files/textures/33.xpm
WE ./files/textures/yns.xpm
R 860 640
SO ./files/textures/44.xpm
S ./files/textures/sans2.xpm

F 70,90,110
C 20,28,40

           1111111  111111111111111
 1 11111111000000011000000000000001
 111110000001111111111111111111111011
  1110000000011122111111111111    111
1111000000001221121000000100001111011
1011020000S000001200000010001000001
1011000001222212210000001000011111
100000021 11111211110111100001111111
11110001    1101100000001000000000001
   10001    1101100101001000111111111
111100021  121011000000010001    
10000000211200001000200010001
10000000000000001000000010001
12000000011110011001010010001
1111011111  11011000000010001
1000000001  10000111011100001
1111101111  10000000000000001
    101     11111111111111111
    111
