NO ./files/textures/11.xpm
EA ./files/textures/test.xpm
WE ./files/textures/22.xpm
R 800 600
SO ./files/textures/test3.XPM
S ./files/textures/chevalier.xpm

F 68,40,25
C 211,93,34

11111111111111
1000000000001
10000000000001
1000000000001
10000000000001
1000000000001
10000000000001
1000000000001
1000000000001
10000000000001
1000000000001
10000000000001
1000000000001
10000000000001
1000000000001
10000000000001
1000000000001
10000000000001
1000000000001
10000000000001
1000000000001
10000000000001
1000000000001
10000000000001
1000000000001
10000000000001
1000000000001
10000000000001
1000000000001
10000000000001
1000000000001
10000000000001
1000000000001
10000000000001
1000000000001
10000000000001
1000000000001
10000000000001
1000000000001
10000000000001
1000000000001
10000000000001
1000000000001
10000000000001
1000000000001
10000000000001
1000000000001
10000000000001
1000000000001
10000000000001
1000000000001
10000000000001
1000000000001
10000000000001
1000000000001
10000000000001
1000000000001
10000000000001
1000000000001
10000000000001
1000000000001
10000000000001
1000000000001
10000000000001
1000000000001
10000000000001
1000000000001
10000000000001
1000000000001
10000000000001
1000000000001
10000000000001
1000000000001
10000000000001
1000000000001
10000000000001
1000000000001
10000000000001
1000000000001
10000000000001
1000000000001
10000000000001
1000000000001
10000000000001
1000000000001
10000000000001
10002E02000001
100000000000001
11111111111111
