R		11   	11
NO		./path_to_the_north_texture
SO 			./path_to_the_south_texture
WE   	./path_to_the_west_texture
EA    ./path_to_the_east_texture
S 		./path_to_the_sprite_texture
F 220,  	100,	0  
C 225	,	30, 0

11111111 1111111111111
11000001110000002000001
1001000000000000000000001
11111111011000001110000000000001
1001 1000001100001110111111111111
11111111111101100000010001
1 11101111111101101010010001
1100000011010101100000010001
1000200000000001100000010001
1000000000000011101001001
110000011101010111011110011
111N011111101011111100001
111 1111111111111111111111
