R 1231   	13551
NO		./path_to_the_north_texture
SO 			./path_to_the_south_texture
WE   	./path_to_the_west_texture
EA    ./path_to_the_east_texture
S 		./path_to_the_sprite_texture
F 220,  	100,	0  
C 225	,	30, 0

11111111 11111111111111111111111
11000001110000002000001111111111
10010000000000000000000011111111
11111111011000001110000000000001
1001 100000110000111011111111111
11111111111101100000010001111111
1 111011111111011010100100011111
11000000110101011000000100011111
10002000000000011000000100011111
10000000000000111010010011111111
11000001110101011101111001111111
111N0111111010111111000011111111
111 111111111111111111111111111111111111111111111111111111111
